xxxxxxxxxxxxxxxx
x  xxxxxxvvssvvx
x              x
xvssxx xxvvssvvx
xxx            x
x v v v v v v vx
xs s s s s s s x
x x x x x     sx
xv v v v v v v x
xvvvvvvvv    vvx
x  f       v ssx
xxxxxxxxxxxxxxxx
